Pigeon
Humming Bird
Pigeon
Sparrow
Map
00000000000000000000000000000000000000000000000
00000000000000000000000000000000000000000000000
00000000000000000000000000000000000000000000000
00000000000000000000000000000000000000000000000
00000000000000000000000000000000000000000000000
00000000000000000000000000000000000000000000000
00000000000000000000000000000000000000000000000
00000000000000000000000000000000000000000000000
00000000000000000000000000000000000000000000000
00000000000000000000000000000000000000000000000
00000000000000000000000000000000000000000000000
00000000000000000000000000000000000000000000000
00000000000000000000000000000000000000000000000
00000000000000000000000000000000000000000000000
00000000000000000000000000000000000000000000000
00000000000000000000000000000000000000000000000
00000000000000000002000002222000200020022222000
00000000000000000002000002002000230020000002000
00000000000000000002000002002000222220022222000
00000000000000000002300002002000000020000302000
00000000000000000002222002222000003020022222000
11111111111111111111111111111111111111111111111
